+--+--+--+--+
|   s |     |
+  +--+--+  +
|        |  |
+--+--+  +  +
|  |     |  |
+  +  +--+  +
|          g|
+--+--+--+--+

