+--+--+--+--+
|           |
+  +--+--+--+
|           |
+  +--+  +  +
|  |g |  |  |
+  +  +--+  +
| s|        |
+--+--+--+--+

