+--+--+--+--+
|    s| g   |
+  +--+--+  +
|        |  |
+--+--+  +  +
|  |     |  |
+  +  +--+  +
|           |
+--+--+--+--+

