+--+--+--+--+
|s          |
+  +--+--+--+
|           |
+  +--+  +  +
|  |  |  |  |
+  +  +--+  +
|  |       g|
+--+--+--+--+

