+--+--+--+--+
|           |
+  +--+--+--+
|           |
+  +--+  +  +
|  |  |  |  |
+  +  +--+  +
| s|       g|
+--+--+--+--+

